SSS.........sss
SSS.........sss
SSS.........sss
SSS.1...#...sss
SSS.....#...sss
SSS....3....sss
SSS...#.....sss
SSS...#...2.sss
SSS.........sss
SSS.........sss
SSS.........sss